111111111111111
1P000000000C001
10C000000000001
10010000C000001
1C01000000000E1
111111111111111