1111111111111111111
1000000000000000001
100000P000000C00001
1000000000C00000001
100E000000000000001
1000000000000000001
1111111111111111111